#######################
#######################
#######################
#CCC############11111##
#CPCH111111111111H111##
#CCCHO11111111111H111##
#111H11111111111OH111##
#111HO11111111111HCCC##
#111H11111111111OHCCC##
H1111O1X1X1X1X111HCCC##
#######################
#######################
#######################

# = Wall
1 = Free space
X = Coin
C = Check point
O = Obstacle