#######################
#######################
#######################
#CCC############11111##
#CPC#111111111111#111##
#CCC#O11111111111#111##
#111#11111111111O#111##
#111#O11111111111#CCC##
#111#11111111111O#CCC##
#1111O111X1X1X111#CCC##
#######################
#######################
#######################
