PLAYER SPEED = 2.5
[] 10 6 3 3 A

#######################
######WWWWWWWWWWWW#####
####WW11111111111WW####
###WPWW111111111WW1W###
###W11WW1111111WW11W###
###W111WW11111WW111W###
###W1111WWA11WW1111W###
###W1111111W1111111W###
###W1111WW111WW1111W###
###W111WW11111WW111W###
###W11WW1111111WW11W###
###W1WW111111111WW1W###
####WW11111111111WW####
######WWWWWWWWWWW######
#######################