#######################
#######################
#######################
#####1111111111111#####
#####1111111111111#####
#CCC#11111XXX11111#CCC#
#CPC111111XXX111111CCC#
#CCC#1111111111111#CCC#
#####1111111111111#####
#####1111111111111#####
#######################
#######################
#######################
