
#######################
#######################
#########C####H########
######H;;;;;;;VC#######
#######1######O########
#######1#CCCC#1########
#######11CPCC1X########
#######1#CCCC#1########
#######V######1########
######1;;;;;;;OH#######
#######H####1##########
#######################
#######################