
#######################
#######################
#########W#############
#######WWCWWWWWW#######
######H;;;;;;;VCW######
######W1WWWWWWOW#######
######W1#CCCCW1W#######
######W11CPCC11W#######
######W1#CCCCW1W#######
######WVWWWWWW1W#######
#####W1;;;;;;;OW#######
######WWWWWW1WWW#######
############W##########
#######################
#######################