#######################
#######################
#########C#############
#######;;;;;;;VC#######
#######1######O########
#######1#CCCC#1########
#######11CPCC11########
#######1#CCCC#1########
#######V######1########
######1;;;;;;;O########
############1##########
#######################
#######################