[] ( 3 7 4 8 7 ; V O

#######################
#######################
#########W#############
#######WWXWWWWWW#######
######H;;;;;;;VCW######
######W1WWWWWWVW#######
######WVWCCCCWVW#######
######WV1CPCC1VW#######
######WVWCCCCW1W#######
######WVWWWWWW1W#######
#####WX;;;;;;;OW#######
######WWWWWWXWWW#######
############W##########
#######################
#######################