PLAYER SPEED = 2.5
[] ( 3 7 4 8 7 ; V O
ch 9 6 4 3

#######################
#######################
#########W#############
#######WWXWWWWWW#######
######H;;;;;;;VCW######
######W1WWWWWWVW#######
######WVW1111WVW#######
######WV11P111VW#######
######WVW1111W1W#######
######WVWWWWWW1W#######
#####WX;;;;;;;OW#######
######WWWWWWXWWW#######
############W##########
#######################
#######################