#######################
#######################
#########C#############
#######111111111#######
#######1######1########
#######1#CCCC#1########
#######11CPCC11########
#######1#CCCC#1########
#######1######1########
######111111111########
############1##########
#######################
#######################