[] ( 2.5 7 4 8 7 ; V O

#######################
#######################
#########W#############
#######WWCWWWWWW#######
######H;;;;;;;VCW######
######W1WWWWWWVW#######
######WV#CCCCWVW#######
######WV1CPCC1VW#######
######WV#CCCCW1W#######
######WVWWWWWW1W#######
#####W1;;;;;;;OW#######
######WWWWWW1WWW#######
############W##########
#######################
#######################