() ( 1.4 11 8 O 2

#######################
#######################
##########CCC##########
##########CCP##########
##########1O1##########
#########11O11#########
########1112111########
#####CC1111O1111#######
#####CCOO2OOO2OO#######
#####CC1111O1111#######
########11121111#######
#########11O111########
##########1O11#########
#######################
#######################

()	(circular movement)
(	(clockwise)
1.4	(angular velocity of circles O and 2)
11 8	(centre of circles O and 2)