#######################
##########CCC##########
##########CCP##########
##########111##########
#########11111#########
########1111111########
#####CC111X1X111#######
#####CC1OOOO1111#######
#####CC111X1X111#######
########11111111#######
#########111111########
##########1111#########
#######################