#######################
#######################
#######################
#######################
##11P###1111##1####1C##
##1#11##1#####11##11###
##1##11111111111##1####
##1#11##1######1111####
##111###1111####11#####
#######################
#######################
#######################
#######################
