- O 1.4
| K 0.7 Y 4.4
() ( 1.5 8 6 B

#######################
#######################
#######################
##H###########H########
##11P##H11O1H#1####1C##
##1#11##B#####K1###1###
##Y##111X1111111##11###
##1#11##1#####H1O1XH###
#H1OXH#H1X1OH###11#####
##H####################
#######################
#######################
#######################
